3,0,0,0,0,0,0,3
 5,3,2,6,5,3,2 
6,0,0,3,0,0,0,6
 2,6,5,3,2,6,5
0,0,0,5,0,0,0,0
 0,0,0,3,0,0,0
0,0,0,5,0,0,0,0